11011011
01100001
10001100
11011111
10001001
11011101
01001101
00101111
00001100
01001101
00010111
00000110
0100
